,Patient,First foveal centre loss (months),VA decline (months),Clinical diagnosis (months),Centre Point Loss to VA Decline,Centre Point Loss to Clinical Diagnosis,VA Decline to Clinical Diagnosis
0,1,2,5,5,3,3,0
1,2,3,8,4,5,1,-4
2,3,4,5,4,1,0,-1
3,4,1,2,2,1,1,0
4,5,3,3,3,0,0,0
5,6,4,7,7,3,3,0
6,7,5,6,6,1,1,0
7,8,2,2,2,0,0,0
8,9,4,3,3,-1,-1,0
9,10,5,6,6,1,1,0
10,11,6,9,9,3,3,0
11,12,3,9,9,6,6,0
12,13,7,7,7,0,0,0
13,14,8,12,8,4,0,-4
14,15,9,11,10,2,1,-1
